word,frequency_reason_fascination,frequency_reason_being_away,frequency_reason_coherence,frequency_reason_scope,total_frequency
buildings,531,542,748,775,2596
trees,836,371,465,266,1938
exploration,59,0,1,1190,1250
greenery,446,379,203,218,1246
road,208,169,289,548,1214
clear,58,157,829,163,1207
pathways,172,104,422,419,1117
escape,1,914,0,0,915
natural,353,254,89,81,777
layout,65,44,590,77,776
organized,39,86,636,14,775
roads,65,213,254,241,773
order,26,8,717,0,751
attention,706,7,0,0,713
arrangement,36,5,656,7,704
visible,14,250,41,369,674
well,148,68,421,11,648
feeling,5,280,89,266,640
somewhat,200,78,137,207,622
demands,0,587,0,0,587
strongly,297,190,15,73,575
boundaries,0,1,5,563,569
appears,15,123,346,80,564
moderate,259,116,71,118,564
open,54,93,6,402,555
sidewalks,32,20,355,148,555
potential,174,129,0,247,550
defined,3,9,300,228,540
might,117,159,74,188,538
distance,46,24,23,436,529
movement,2,2,1,518,523
like,154,236,57,71,518
modern,277,97,123,3,500
setting,53,375,16,55,499
spaces,46,133,127,187,493
fascination,492,0,0,0,492
suggesting,47,76,95,264,482
green,43,123,121,173,460
easy,0,0,459,1,460
limit,219,42,2,169,432
parked,171,164,32,63,430
rather,108,175,26,112,421
impression,169,18,70,162,419
landscaping,70,28,287,31,416
cars,116,228,12,54,410
refuge,0,409,0,0,409
away,0,400,0,5,405
place,25,152,207,19,403
captivating,399,0,1,0,400
one,93,128,48,119,388
coherence,0,0,383,0,383
provides,103,221,3,51,378
limited,100,39,3,235,377
along,83,46,134,112,375
structured,19,51,256,48,374
paved,84,120,116,52,372
typical,2,365,0,0,367
degree,41,109,173,42,365
maintained,154,57,151,2,364
orderly,57,85,221,0,363
contribute,105,74,153,25,357
complete,1,351,2,1,355
directions,2,0,3,347,352
lacks,303,23,16,1,343
exhibits,0,0,338,0,338
immediate,13,133,3,186,335
scope,1,0,0,333,334
view,21,20,8,283,332
organization,2,2,327,1,332
presents,79,63,51,134,327
relatively,45,170,43,63,321
building,128,48,101,42,319
functional,86,176,38,16,316
create,66,44,83,118,311
strong,99,110,76,25,310
would,253,10,10,33,306
everyday,5,293,0,0,298
nature,128,86,29,55,298
architecture,237,14,40,2,293
nuisances,0,291,0,0,291
contributing,21,16,237,14,288
capture,285,0,0,1,286
understand,0,0,284,0,284
expansive,4,4,0,273,281
engaging,277,1,1,0,279
architectural,140,5,133,0,278
consistent,24,1,248,3,276
paths,49,30,83,113,275
possibilities,2,0,0,272,274
parking,48,47,119,57,271
separation,0,242,27,0,269
leading,87,12,34,135,268
contributes,47,50,146,16,259
image,12,38,54,152,256
draw,251,0,0,0,251
manicured,52,33,132,30,247
vehicles,67,137,19,18,241
hold,237,0,0,0,237
mental,0,234,2,0,236
limiting,48,62,0,126,236
provide,78,130,3,18,229
within,5,48,81,93,227
uniform,177,2,44,3,226
lined,84,75,21,44,224
multiple,30,2,2,190,224
path,38,27,31,126,222
features,195,12,10,5,222
planned,0,1,214,7,222
boredom,221,0,0,0,221
varied,171,0,30,17,218
lack,150,27,19,21,217
life,1,215,0,0,216
openness,1,6,0,208,215
neatly,38,4,165,4,211
structure,11,2,186,12,211
vastness,0,1,0,209,210
infrastructure,35,96,34,44,209
could,56,105,9,37,207
calm,29,172,3,0,204
atmosphere,22,181,0,0,203
tree,73,66,21,43,203
sky,100,50,1,52,203
many,92,3,0,105,200
surrounding,18,12,31,138,199
detachment,0,195,0,0,195
distinct,81,46,60,8,195
different,9,10,91,85,195
creates,46,37,60,51,194
landscape,27,12,73,81,193
extends,0,0,0,193,193
design,45,5,137,5,192
evoke,23,162,0,4,189
limits,114,22,0,48,184
everything,0,0,183,0,183
repetitive,179,0,3,0,182
pleasant,128,36,0,15,179
activity,60,115,1,2,178
details,174,0,2,0,176
quiet,5,168,0,0,173
arranged,6,0,165,2,173
unique,169,0,2,0,171
difficult,140,15,13,0,168
offering,39,42,0,86,167
moderately,111,3,22,30,166
boundless,0,0,0,165,165
physical,0,0,162,3,165
concerns,0,164,0,0,164
extensive,2,5,3,154,164
wide,19,12,7,123,161
feels,7,81,17,54,159
vast,1,0,2,156,159
still,0,155,0,2,157
water,56,51,16,34,157
pathway,40,29,27,59,155
present,58,16,39,41,154
bored,154,0,0,0,154
feel,17,71,39,26,153
distant,71,20,6,56,153
perceived,7,12,8,125,152
structures,56,22,40,32,150
prevent,132,12,4,1,149
hustle,0,148,0,0,148
respite,0,148,0,0,148
appear,2,11,105,29,147
peaceful,13,131,0,0,144
possibility,15,8,0,119,142
traffic,25,94,12,10,141
particularly,99,17,13,11,140
good,11,12,94,23,140
discovery,23,0,0,115,138
though,28,26,52,31,137
fascinating,137,0,0,0,137
predictability,5,0,132,0,137
clearly,4,19,89,24,136
opportunities,27,2,0,107,136
residential,10,78,18,29,135
break,2,131,0,0,133
make,106,5,22,0,133
sustained,132,0,0,0,132
construction,38,35,43,15,131
absence,27,92,2,8,129
depicts,1,36,7,84,128
clean,42,74,10,0,126
less,50,27,43,6,126
engagement,124,1,0,1,126
distractions,2,123,0,0,125
context,0,70,5,49,124
variety,117,0,1,6,124
extending,1,0,0,123,124
logical,0,0,123,0,123
usual,0,121,0,0,121
convey,0,34,11,76,121
spatial,0,1,111,8,120
visually,92,15,11,1,119
contained,1,1,1,115,118
allowing,1,75,4,37,117
due,42,48,12,13,115
bustle,0,113,0,0,113
manner,1,0,112,0,113
integrated,2,24,80,2,108
placement,0,0,108,0,108
ample,7,27,0,72,106
routines,0,105,0,0,105
departure,0,105,0,0,105
lush,87,18,0,0,105
enough,50,6,3,46,105
high,39,5,46,15,105
style,10,2,93,0,105
institutional,11,81,5,7,104
demanding,0,103,0,0,103
bicycles,70,13,16,4,103
extent,8,0,0,94,102
proper,0,0,102,0,102
location,1,97,0,3,101
grassy,7,10,25,59,101
potentially,37,46,5,12,100
background,33,13,31,23,100
truly,32,51,0,16,99
perceive,0,0,98,1,99
freedom,0,0,0,98,98
large,32,13,4,46,95
diverse,81,0,3,10,94
makes,14,9,70,0,93
imply,0,4,2,87,93
designated,0,0,91,2,93
unlikely,64,28,0,0,92
bordered,3,7,19,63,92
dynamic,92,0,0,0,92
tasks,0,91,0,0,91
generally,19,32,38,2,91
slightly,9,15,63,4,91
overcast,68,21,0,1,90
may,17,35,1,36,89
allows,0,23,2,64,89
typically,64,22,1,2,89
repetition,81,0,8,0,89
planted,4,0,81,4,89
experience,56,19,8,5,88
move,0,2,1,85,88
displays,2,0,74,11,87
removed,0,86,0,0,86
implies,0,9,1,76,86
seems,0,7,64,15,86
active,4,79,1,1,85
canal,27,20,19,19,85
interesting,84,0,1,0,85
hard,84,0,0,0,84
quite,27,13,18,25,83
predictable,11,0,71,1,83
stressors,0,82,0,0,82
tranquil,3,79,0,0,82
streets,8,26,30,18,82
perception,0,9,18,55,82
monotonous,75,0,7,0,82
streetlights,15,12,54,0,81
markings,15,14,50,1,80
larger,0,1,1,78,80
points,80,0,0,0,80
lines,10,4,53,12,79
fences,2,1,6,70,79
sports,18,16,24,20,78
bushes,37,5,35,1,78
mix,53,0,25,0,78
trimmed,16,2,57,2,77
without,22,0,2,53,77
surroundings,5,20,6,45,76
understandable,0,0,76,0,76
creating,11,9,45,10,75
numerous,42,2,0,31,75
indicate,0,53,8,13,74
fully,5,51,3,15,74
general,24,23,15,12,74
highly,65,1,8,0,74
scattered,26,0,48,0,74
lot,23,18,12,20,73
deep,63,4,2,3,72
utilitarian,36,21,11,2,70
built,7,17,21,25,70
detract,22,14,34,0,70
primarily,9,12,1,48,70
intentional,1,0,69,0,70
prominent,17,32,10,10,69
implying,0,4,5,60,69
things,35,2,32,0,69
mature,66,2,0,0,68
organizational,0,0,68,0,68
TRUE,0,67,0,0,67
likely,30,29,1,7,67
reasonable,0,6,23,38,67
expanse,3,0,2,62,67
pressures,0,66,0,0,66
grass,25,15,24,2,66
landscaped,10,4,42,10,66
lining,28,0,20,18,66
explore,6,0,0,60,66
fit,0,0,66,0,66
indicates,0,57,5,3,65
depth,16,1,0,48,65
minimal,13,49,1,1,64
spaced,5,0,59,0,64
together,0,0,64,0,64
dominated,41,3,0,19,63
easily,2,10,50,0,62
debris,22,7,31,2,62
winding,42,4,3,13,62
low,32,21,6,2,61
designed,10,12,35,4,61
foliage,53,2,2,4,61
complexity,58,0,3,0,61
styles,28,0,33,0,61
hedges,19,0,35,6,60
streetscape,30,19,4,6,59
uniformity,47,1,9,2,59
linear,7,0,18,33,58
side,3,0,8,47,58
coherent,0,0,57,1,58
shows,0,0,14,44,58
worries,0,57,0,0,57
serene,11,46,0,0,57
people,21,35,0,1,57
pedestrian,6,18,27,6,57
body,22,11,5,19,57
entirely,12,28,6,10,56
ordered,10,16,30,0,56
secluded,0,55,0,0,55
including,30,7,11,7,55
part,0,27,20,7,54
environments,10,33,7,3,53
industrial,15,21,7,10,53
walkways,13,10,23,7,53
broad,0,0,1,52,53
activities,19,33,0,0,52
intricate,48,0,4,0,52
various,12,0,4,36,52
evenly,3,0,49,0,52
confined,0,0,0,52,52
discernible,0,2,47,2,51
hints,13,4,0,33,50
sides,2,3,10,35,50
exceptionally,39,0,9,2,50
unbounded,0,0,0,50,50
responsibilities,0,49,0,0,49
busy,0,49,0,0,49
ability,37,5,0,7,49
neat,8,1,40,0,49
beyond,4,0,1,44,49
comprehend,0,0,49,0,49
extend,0,0,0,49,49
abundant,19,27,0,2,48
thus,7,24,4,13,48
park,5,24,6,13,48
materials,10,6,32,0,48
adjacent,1,3,5,39,48
perfect,0,1,47,0,48
human,11,36,0,0,47
seem,0,0,38,9,47
integration,0,0,47,0,47
vegetation,10,2,19,15,46
retreat,0,45,0,0,45
routine,5,40,0,0,45
work,0,39,3,3,45
cues,0,5,2,38,45
blend,40,0,3,2,45
developed,0,30,4,10,44
decent,2,25,1,16,44
appearance,4,24,15,1,44
overwhelming,18,10,3,13,44
immediately,6,5,16,17,44
overly,12,3,2,27,44
long,13,2,0,29,44
straight,9,2,12,21,44
lead,9,0,8,27,44
perfectly,0,0,44,0,44
contrast,9,27,7,0,43
towards,8,6,8,21,43
planning,2,3,35,3,43
deeply,34,1,8,0,43
textures,40,0,3,0,43
patterns,35,0,8,0,43
complex,16,1,12,13,42
novelty,42,0,0,0,42
discover,1,0,0,41,42
limitless,0,0,0,42,42
completely,5,34,0,2,41
coupled,10,25,0,6,41
significant,1,23,4,13,41
largely,8,2,0,31,41
places,1,1,38,1,41
overwhelmingly,38,0,0,3,41
either,3,0,1,37,41
profound,1,36,3,0,40
allow,0,13,1,26,40
cones,18,9,8,5,40
dense,13,9,1,17,40
detracts,27,4,9,0,40
development,2,4,23,11,40
leaves,27,2,11,0,40
around,2,2,6,30,40
varying,30,0,10,0,40
deliberate,0,0,40,0,40
ongoing,2,28,5,4,39
stimulating,35,4,0,0,39
hills,14,3,0,22,39
bordering,0,1,28,10,39
city,0,38,0,0,38
associated,14,22,0,2,38
rich,37,0,0,1,38
inherent,32,0,6,0,38
symmetrical,0,0,38,0,38
breadth,0,0,0,38,38
abundance,15,22,0,0,37
alongside,10,2,15,10,37
detail,36,0,1,0,37
room,0,0,0,37,37
albeit,9,10,10,7,36
implied,1,10,0,25,36
apartment,15,7,9,5,36
flanked,2,2,8,24,36
combination,31,1,4,0,36
focal,36,0,0,0,36
novel,35,0,0,1,36
way,9,0,27,0,36
stretching,1,0,1,34,36
lanes,1,0,29,6,36
limitations,0,0,0,36,36
follow,0,0,33,3,36
understanding,0,0,36,0,36
thoughts,0,35,0,0,35
serve,0,34,1,0,35
temporary,2,24,8,1,35
managed,0,20,5,10,35
lake,8,9,6,12,35
lawns,7,4,22,2,35
engage,34,1,0,0,35
capacity,23,1,0,11,35
facades,23,1,7,4,35
navigate,0,1,32,2,35
subtly,0,0,1,34,35
constrained,0,0,0,35,35
possibly,1,27,2,4,34
providing,8,19,0,7,34
wilderness,0,18,0,16,34
captivate,34,0,0,0,34
accessible,0,29,0,4,33
suburban,0,26,0,7,33
signs,4,24,5,0,33
wild,1,22,0,10,33
surfaces,12,13,5,3,33
resulting,6,12,5,10,33
man,21,8,1,3,33
made,21,8,1,3,33
intersection,2,5,12,14,33
barriers,6,4,3,20,33
boring,33,0,0,0,33
eye,29,0,3,1,33
aesthetic,25,0,8,0,33
framed,0,0,0,33,33
crowds,0,32,0,0,32
characterized,5,22,2,3,32
therefore,15,10,0,7,32
field,6,5,7,14,32
court,12,4,8,8,32
intended,0,1,31,0,32
uniformly,5,0,27,0,32
flow,1,0,30,1,32
hinting,0,0,0,32,32
opportunity,4,13,0,14,31
find,20,11,0,0,31
although,3,8,4,16,31
courts,8,4,7,12,31
encourage,5,2,0,24,31
gentle,30,1,0,0,31
perspective,5,1,2,23,31
detach,0,30,0,0,30
thinking,0,30,0,0,30
bustling,1,29,0,0,30
aspect,16,13,1,0,30
hint,5,7,0,18,30
engaged,26,4,0,0,30
inherently,19,3,0,8,30
adds,27,1,2,0,30
even,4,24,0,1,29
certain,0,0,3,26,29
placed,0,0,29,0,29
proximity,0,27,0,1,28
stop,2,26,0,0,28
appealing,22,6,0,0,28
apparent,0,4,3,21,28
preventing,17,2,0,9,28
network,3,2,4,19,28
drawing,28,0,0,0,28
add,24,0,3,1,28
pattern,7,0,21,0,28
conducive,1,26,0,0,27
restorative,5,21,0,1,27
intriguing,27,0,0,0,27
appeal,27,0,0,0,27
subtle,19,0,1,7,27
laid,0,0,27,0,27
seamless,0,0,27,0,27
disconnect,0,26,0,0,26
ambiance,4,22,0,0,26
facilitating,0,21,5,0,26
vehicle,6,17,1,2,26
focus,14,7,1,4,26
specific,8,3,0,15,26
walk,0,2,0,24,26
moving,0,2,0,24,26
curving,7,1,2,16,26
lane,1,1,23,1,26
striking,23,0,3,0,26
wander,1,0,0,25,26
harmonious,0,0,26,0,26
obligations,0,25,0,0,25
common,7,18,0,0,25
slight,4,9,12,0,25
aspects,12,8,1,4,25
stadium,10,4,7,4,25
compared,1,3,2,19,25
unexpected,24,0,1,0,25
paving,14,0,11,0,25
spaciousness,0,0,0,25,25
unlimited,0,0,0,25,25
mundane,15,9,0,0,24
foreground,3,2,1,18,24
amount,10,1,2,11,24
drawn,24,0,0,0,24
composition,11,0,11,2,24
reasonably,8,0,5,11,24
vista,2,0,0,22,24
logically,0,0,24,0,24
forward,0,0,1,23,24
edges,0,0,3,21,24
immersion,1,21,0,1,23
chaotic,1,14,8,0,23
combined,11,9,1,2,23
walking,11,6,0,6,23
necessarily,3,6,6,8,23
viewer,17,5,1,0,23
concrete,11,5,4,3,23
dominant,18,3,2,0,23
lacking,22,0,1,0,23
rows,11,0,11,1,23
progression,2,0,7,14,23
planting,1,0,22,0,23
facilitate,0,21,0,1,22
perhaps,1,16,1,4,22
connected,0,15,5,2,22
feature,9,8,3,2,22
lower,7,4,0,11,22
overtly,15,3,1,3,22
intensely,20,2,0,0,22
grounds,1,2,10,9,22
stimuli,21,1,0,0,22
freely,0,1,0,21,22
curiosity,22,0,0,0,22
extended,19,0,0,3,22
new,6,0,0,16,22
quietness,6,15,0,0,21
car,4,15,0,2,21
prevents,5,14,2,0,21
lots,4,7,1,9,21
repeating,16,0,4,1,21
branching,6,0,0,15,21
continuous,4,0,0,17,21
scale,2,0,1,18,21
vistas,1,0,0,20,21
venturing,0,0,0,21,21
mentally,0,16,4,0,20
mild,13,7,0,0,20
significantly,16,2,1,1,20
bridge,10,0,9,1,20
restrict,0,0,0,20,20
unified,0,0,20,0,20
unexplored,0,0,0,20,20
ease,0,0,20,0,20
buffer,0,19,0,0,19
public,0,16,2,1,19
featuring,6,9,2,2,19
enhances,1,7,9,2,19
scooters,15,2,2,0,19
lamps,10,2,7,0,19
orderliness,0,1,17,1,19
windows,19,0,0,0,19
consistently,18,0,1,0,19
ahead,10,0,1,8,19
minor,9,0,10,0,19
invite,7,0,0,12,19
shrubs,6,0,13,0,19
stretches,1,0,0,18,19
impose,0,0,0,19,19
cohesive,0,0,19,0,19
related,0,18,0,0,18
controlled,1,13,0,4,18
visibility,0,9,0,9,18
quality,11,6,0,1,18
backdrop,7,4,2,5,18
evident,0,3,7,8,18
density,4,2,2,10,18
unusual,17,1,0,0,18
interspersed,12,1,5,0,18
division,1,1,15,1,18
purpose,0,1,16,1,18
observe,16,0,0,2,18
similar,15,0,3,0,18
simple,5,0,13,0,18
intentionally,1,0,17,0,18
panoramic,0,0,12,6,18
outdoor,2,13,1,1,17
clutter,0,12,4,1,17
walkway,2,6,7,2,17
pond,7,5,1,4,17
purely,12,4,0,1,17
enhance,4,4,6,3,17
yet,6,3,8,0,17
created,2,3,0,12,17
unfinished,8,2,6,1,17
enclosed,0,2,0,15,17
marked,0,2,10,5,17
glimpses,14,1,0,2,17
lampposts,7,1,9,0,17
unkempt,4,1,12,0,17
left,3,1,2,11,17
intrigue,17,0,0,0,17
pavement,11,0,5,1,17
fashion,1,0,16,0,17
direction,1,0,2,14,17
broader,0,0,0,17,17
disjointed,0,0,17,0,17
parallel,0,0,14,3,17
systematic,0,0,17,0,17
restricted,0,0,0,17,17
semi,1,15,0,0,16
recreational,1,8,5,2,16
intense,9,7,0,0,16
continuation,0,1,0,15,16
discovering,1,0,0,15,16
aligned,0,0,16,0,16
parts,0,0,7,9,16
introduce,0,0,12,4,16
nuisures,0,15,0,0,15
escaping,0,15,0,0,15
separate,0,15,0,0,15
disengage,0,15,0,0,15
connection,0,14,1,0,15
academic,0,14,1,0,15
much,7,6,0,2,15
fallen,6,2,7,0,15
deeper,11,1,0,3,15
higher,6,1,6,2,15
line,3,1,1,10,15
flanking,1,1,4,9,15
implicit,0,1,0,14,15
depicted,0,1,0,14,15
central,0,1,13,1,15
beauty,15,0,0,0,15
interplay,15,0,0,0,15
prolonged,15,0,0,0,15
designs,14,0,1,0,15
ground,7,0,8,0,15
expansiveness,0,0,0,15,15
comprehensibility,0,0,15,0,15
disrupt,0,0,15,0,15
relate,0,0,15,0,15
noise,0,14,0,0,14
momentarily,0,14,0,0,14
partial,0,14,0,0,14
chaos,0,14,0,0,14
center,1,12,1,0,14
relative,0,12,1,1,14
ordinary,6,8,0,0,14
spacious,0,7,0,7,14
signage,6,6,2,0,14
sparse,10,4,0,0,14
obvious,0,4,2,8,14
regular,2,3,9,0,14
use,1,3,10,0,14
sightlines,0,3,2,9,14
point,9,2,1,2,14
maintenance,0,1,13,0,14
periods,14,0,0,0,14
reduce,10,0,4,0,14
straightforward,9,0,3,2,14
site,6,0,5,3,14
landscapes,3,0,1,10,14
sidewalk,1,0,6,7,14
disorganized,1,0,13,0,14
grasp,0,0,14,0,14
harmony,0,0,14,0,14
follows,0,0,14,0,14
demonstrates,0,0,14,0,14
remote,0,13,0,0,13
inhabited,0,13,0,0,13
temporarily,0,13,0,0,13
settings,1,10,0,2,13
light,6,7,0,0,13
free,0,4,0,9,13
pleasing,5,3,5,0,13
reducing,8,2,3,0,13
aesthetically,4,2,7,0,13
tidiness,2,2,9,0,13
encourages,1,2,0,10,13
right,4,1,6,2,13
disarray,1,1,11,0,13
leads,0,1,2,10,13
situated,0,1,12,0,13
captivated,13,0,0,0,13
stimulation,13,0,0,0,13
several,11,0,0,2,13
predominantly,7,0,0,6,13
fairly,4,0,2,7,13
diverging,2,0,4,7,13
understood,0,0,13,0,13
considerable,0,0,0,13,13
sanctuary,0,12,0,0,12
naturalistic,1,8,2,1,12
looking,3,7,1,1,12
person,6,6,0,0,12
fostering,0,5,3,4,12
indicating,0,4,5,3,12
enclosure,0,4,0,8,12
sterile,9,3,0,0,12
cycling,9,3,0,0,12
roadways,1,3,4,4,12
bicycle,7,2,3,0,12
cityscape,4,2,0,6,12
cyclist,11,1,0,0,12
tennis,5,1,1,5,12
views,2,1,0,9,12
spontaneous,12,0,0,0,12
touch,11,0,1,0,12
discoveries,11,0,0,1,12
juxtaposition,3,0,9,0,12
endless,0,0,0,12,12
confinement,0,0,0,12,12
encountering,0,0,0,12,12
intersecting,0,0,3,9,12
reflects,4,5,1,1,11
functionality,4,5,2,0,11
entrance,0,5,3,3,11
empty,8,3,0,0,11
partially,3,3,3,2,11
zone,0,3,4,4,11
qualities,9,2,0,0,11
power,8,2,1,0,11
transition,0,2,9,0,11
appearing,0,2,8,1,11
explicitly,0,2,0,9,11
subdued,10,1,0,0,11
monotony,11,0,0,0,11
wonder,11,0,0,0,11
repeated,10,0,1,0,11
multitude,5,0,0,6,11
planters,5,0,6,0,11
scattering,4,0,7,0,11
restricts,2,0,0,9,11
exhibit,1,0,10,0,11
unrestricted,0,0,0,11,11
understandability,0,0,11,0,11
horizon,0,0,0,11,11
panorama,0,0,5,6,11
navigable,0,0,7,4,11
bounded,0,0,0,11,11
delineation,0,0,9,2,11
delineated,0,0,11,0,11
curbs,0,0,2,9,11
expanses,0,0,0,11,11
get,0,10,0,0,10
everyone,0,9,1,0,10
overt,1,8,0,1,10
kept,1,6,2,1,10
dimension,5,4,0,1,10
supports,0,4,3,3,10
facilities,0,4,4,2,10
equipment,7,3,0,0,10
scores,4,3,1,2,10
fencing,0,2,5,3,10
sufficient,4,1,0,5,10
presented,3,1,3,3,10
indications,0,1,0,9,10
reinforces,0,1,9,0,10
weeping,10,0,0,0,10
little,10,0,0,0,10
curve,10,0,0,0,10
mildly,10,0,0,0,10
become,10,0,0,0,10
forks,1,0,0,9,10
undeveloped,1,0,3,6,10
fenced,0,0,2,8,10
wandering,0,0,0,10,10
journey,0,0,0,10,10
explored,0,0,0,10,10
disengagement,0,9,0,0,9
distracting,0,9,0,0,9
familiar,0,9,0,0,9
mind,1,8,0,0,9
transit,0,8,0,1,9
despite,0,7,1,1,9
temper,3,6,0,0,9
suggested,0,6,0,3,9
distinctly,5,4,0,0,9
scoring,3,4,1,1,9
leans,5,3,1,0,9
roadway,2,3,1,3,9
commercial,2,3,2,2,9
found,6,2,0,1,9
benches,5,2,2,0,9
waterway,3,2,1,3,9
tower,7,1,1,0,9
drive,6,1,0,2,9
seating,3,1,4,1,9
dividers,1,1,6,1,9
possible,0,1,0,8,9
dappled,9,0,0,0,9
compelling,8,0,1,0,9
introduces,1,0,8,0,9
terms,1,0,3,5,9
meticulously,1,0,8,0,9
terrain,1,0,6,2,9
explorable,0,0,0,9,9
able,0,0,0,9,9
relationships,0,0,9,0,9
uneven,0,0,9,0,9
belong,0,0,9,0,9
clarity,0,0,9,0,9
navigation,0,0,8,1,9
seclusion,0,8,0,0,8
stepping,0,8,0,0,8
populated,0,8,0,0,8
stresses,0,8,0,0,8
uncluttered,0,8,0,0,8
reprieve,0,8,0,0,8
pedestrians,1,7,0,0,8
characteristics,1,7,0,0,8
peace,1,7,0,0,8
intensity,1,7,0,0,8
anchors,0,7,1,0,8
relaxation,0,7,1,0,8
thoroughfare,0,6,0,2,8
calming,3,5,0,0,8
distraction,3,5,0,0,8
skies,2,5,0,1,8
occasional,2,5,1,0,8
full,2,5,0,1,8
cyclists,5,3,0,0,8
suggestion,2,3,0,3,8
basketball,3,2,1,2,8
bins,2,2,4,0,8
underlying,0,1,6,1,8
surprise,8,0,0,0,8
sunlight,8,0,0,0,8
small,8,0,0,0,8
spark,8,0,0,0,8
neither,8,0,0,0,8
lamppost,8,0,0,0,8
balance,8,0,0,0,8
filtering,8,0,0,0,8
reduces,7,0,1,0,8
sculpture,6,0,2,0,8
fork,5,0,1,2,8
stones,4,0,4,0,8
railings,4,0,3,1,8
spacing,2,0,6,0,8
patches,2,0,3,3,8
inviting,2,0,2,4,8
frame,1,0,1,6,8
curves,1,0,1,6,8
containment,0,0,0,8,8
zones,0,0,4,4,8
length,0,0,0,8,8
restrictive,0,0,0,8,8
see,0,0,3,5,8
intuitive,0,0,8,0,8
fragmented,0,0,8,0,8
width,0,0,0,8,8
indoor,0,7,0,0,7
diminishes,0,7,0,0,7
contemplation,0,7,0,0,7
core,0,7,0,0,7
diminish,0,7,0,0,7
effectively,0,7,0,0,7
step,0,7,0,0,7
transitional,0,6,1,0,7
immersive,2,5,0,0,7
security,2,5,0,0,7
peacefulness,2,5,0,0,7
remains,0,5,2,0,7
control,0,5,2,0,7
utility,3,4,0,0,7
facility,1,4,1,1,7
canopy,4,3,0,0,7
needed,3,3,1,0,7
main,0,3,0,4,7
primary,2,2,0,3,7
vehicular,0,2,5,0,7
dominance,6,1,0,0,7
number,5,1,0,1,7
often,4,1,0,2,7
system,0,1,5,1,7
avoid,7,0,0,0,7
observation,7,0,0,0,7
overcome,7,0,0,0,7
engrossed,7,0,0,0,7
richness,7,0,0,0,7
banners,5,0,2,0,7
grand,5,0,0,2,7
stone,4,0,3,0,7
variations,3,0,4,0,7
naturally,3,0,4,0,7
narrative,1,0,6,0,7
piles,1,0,6,0,7
walls,1,0,0,6,7
sized,0,0,0,7,7
discern,0,0,7,0,7
others,0,0,7,0,7
thoughtfully,0,0,7,0,7
framing,0,0,0,7,7
positioned,0,0,7,0,7
imposed,0,0,0,7,7
define,0,0,0,7,7
periphery,0,0,1,6,7
layouts,0,0,7,0,7
boundary,0,0,1,6,7
comprehension,0,0,7,0,7
detached,0,6,0,0,6
heavy,0,6,0,0,6
help,0,6,0,0,6
pressing,0,6,0,0,6
study,0,6,0,0,6
world,0,6,0,0,6
tied,0,6,0,0,6
urbanized,0,6,0,0,6
crowded,1,5,0,0,6
individuals,2,4,0,0,6
cover,1,4,0,1,6
business,1,4,0,1,6
bikes,1,4,0,1,6
moderating,0,4,0,2,6
indicated,0,4,0,2,6
portrays,0,4,0,2,6
university,0,4,1,1,6
profoundly,3,3,0,0,6
set,3,3,0,0,6
bus,2,3,1,0,6
disconnected,0,3,3,0,6
pure,4,2,0,0,6
sensory,4,2,0,0,6
scooter,4,2,0,0,6
crane,3,2,1,0,6
sufficiently,2,2,0,2,6
covered,2,2,1,1,6
traditional,4,1,1,0,6
waterfront,2,1,0,3,6
single,2,1,0,3,6
exploring,1,1,0,4,6
fence,1,1,1,3,6
seemingly,1,1,3,1,6
plaza,1,1,1,3,6
fields,0,1,1,4,6
disruption,0,1,5,0,6
indication,0,1,0,5,6
period,6,0,0,0,6
passive,6,0,0,0,6
willows,6,0,0,0,6
willow,6,0,0,0,6
muted,6,0,0,0,6
captivation,6,0,0,0,6
draws,6,0,0,0,6
texture,5,0,1,0,6
young,5,0,1,0,6
brick,4,0,2,0,6
crosswalks,3,0,3,0,6
mostly,2,0,1,3,6
basic,1,0,5,0,6
available,0,0,0,6,6
routes,0,0,0,6,6
harmoniously,0,0,6,0,6
infinite,0,0,0,6,6
implicitly,0,0,0,6,6
continuity,0,0,1,5,6
disrupts,0,0,6,0,6
comprehensible,0,0,6,0,6
conveyed,0,0,0,6,6
components,0,0,6,0,6
property,0,0,0,6,6
territory,0,0,0,6,6
unhindered,0,0,0,6,6
route,0,0,1,5,6
seamlessly,0,0,6,0,6
wider,0,0,0,6,6
cease,0,5,0,0,5
occupied,0,5,0,0,5
serves,0,5,0,0,5
stopping,0,5,0,0,5
need,0,5,0,0,5
psychological,0,5,0,0,5
office,0,5,0,0,5
nuisà°·à±à°s,0,5,0,0,5
direct,1,4,0,0,5
evokes,1,4,0,0,5
finding,1,4,0,0,5
diminishing,0,4,1,0,5
trash,2,3,0,0,5
prevalence,2,3,0,0,5
far,0,3,0,2,5
truck,0,3,2,0,5
standard,3,2,0,0,5
foster,3,2,0,0,5
generic,2,2,1,0,5
leaning,2,2,1,0,5
especially,1,2,2,0,5
state,1,2,2,0,5
spots,0,2,3,0,5
put,0,2,3,0,5
scenery,4,1,0,0,5
plain,4,1,0,0,5
lamp,3,1,1,0,5
50,3,1,1,0,5
multi,2,1,1,1,5
challenging,1,1,3,0,5
wilder,1,1,1,2,5
dominate,1,1,3,0,5
obscured,1,1,0,3,5
fair,0,1,1,3,5
conveys,0,1,1,3,5
appropriate,0,1,4,0,5
form,0,1,3,1,5
forming,0,1,4,0,5
positively,0,1,4,0,5
colors,5,0,0,0,5
distinctive,5,0,0,0,5
glass,5,0,0,0,5
lily,5,0,0,0,5
window,5,0,0,0,5
look,5,0,0,0,5
decorative,5,0,0,0,5
colorful,5,0,0,0,5
stimulate,5,0,0,0,5
surprising,5,0,0,0,5
pads,5,0,0,0,5
clouds,5,0,0,0,5
cloudy,5,0,0,0,5
considered,5,0,0,0,5
static,5,0,0,0,5
archway,3,0,2,0,5
avenue,3,0,0,2,5
branches,3,0,0,2,5
wall,3,0,0,2,5
facade,3,0,1,1,5
bridges,2,0,1,2,5
mixture,2,0,3,0,5
patterned,2,0,3,0,5
regularity,1,0,4,0,5
yellow,1,0,4,0,5
branch,1,0,0,4,5
balanced,1,0,4,0,5
continues,0,0,0,5,5
sections,0,0,3,2,5
logic,0,0,5,0,5
destinations,0,0,0,5,5
located,0,0,5,0,5
principle,0,0,5,0,5
interconnected,0,0,2,3,5
stitching,0,0,5,0,5
edge,0,0,3,2,5
whole,0,0,5,0,5
belongs,0,0,5,0,5
blocks,0,0,3,2,5
perimeters,0,0,0,5,5
divisions,0,0,5,0,5
travel,0,0,0,5,5
cluttered,0,4,0,0,4
total,0,4,0,0,4
plausible,0,4,0,0,4
tranquility,0,4,0,0,4
brief,0,4,0,0,4
civilization,0,4,0,0,4
nuisculoskeletal,0,4,0,0,4
effectiveness,0,4,0,0,4
extension,0,4,0,0,4
urgent,0,4,0,0,4
shift,0,4,0,0,4
getaway,0,4,0,0,4
intrusive,0,4,0,0,4
isolated,0,4,0,0,4
leisure,0,4,0,0,4
promoting,0,4,0,0,4
lived,0,4,0,0,4
almost,1,3,0,0,4
leafy,1,3,0,0,4
softened,1,3,0,0,4
transport,1,3,0,0,4
stark,0,3,1,0,4
management,1,2,1,0,4
indicators,0,2,0,2,4
idea,0,2,1,1,4
hence,0,2,0,2,4
provided,0,2,1,1,4
aids,0,2,2,0,4
stream,3,1,0,0,4
modest,3,1,0,0,4
pavilion,3,1,0,0,4
story,2,1,0,1,4
community,1,1,1,1,4
developing,1,1,2,0,4
river,1,1,1,1,4
pile,1,1,2,0,4
scaffolding,1,1,1,1,4
connectivity,0,1,0,3,4
facilitates,0,1,3,0,4
vegetated,0,1,0,3,4
captures,4,0,0,0,4
impossible,4,0,0,0,4
forms,4,0,0,0,4
balconies,4,0,0,0,4
tall,4,0,0,0,4
partly,4,0,0,0,4
uniquely,4,0,0,0,4
pull,4,0,0,0,4
shapes,4,0,0,0,4
array,3,0,0,1,4
bamboo,3,0,1,0,4
split,3,0,0,1,4
maintain,3,0,1,0,4
composed,2,0,0,2,4
bit,2,0,2,0,4
undergrowth,2,0,2,0,4
overgrown,2,0,0,2,4
45,2,0,1,1,4
bays,1,0,3,0,4
consists,1,0,0,3,4
directional,1,0,1,2,4
harder,1,0,3,0,4
structural,1,0,3,0,4
lawn,1,0,0,3,4
horizons,0,0,0,4,4
crossings,0,0,4,0,4
exploratory,0,0,0,4,4
intuitively,0,0,4,0,4
irregular,0,0,4,0,4
plan,0,0,4,0,4
neatness,0,0,3,1,4
followed,0,0,0,4,4
arrangements,0,0,4,0,4
sight,0,0,3,1,4
ended,0,0,0,4,4
defining,0,0,0,4,4
reveals,0,0,2,2,4
regularly,0,0,4,0,4
systematically,0,0,4,0,4
avenues,0,0,0,4,4
angle,0,0,0,4,4
encompasses,0,0,0,4,4
show,0,0,4,0,4
constructed,0,0,2,2,4
disorder,0,0,4,0,4
unconstrained,0,0,0,4,4
neighborhood,0,0,0,4,4
substantial,0,0,0,4,4
haphazard,0,0,4,0,4
expected,0,0,4,0,4
particular,0,0,0,4,4
traversed,0,0,0,4,4
traverse,0,0,0,4,4
shown,0,0,0,4,4
measures,0,3,0,0,3
aiding,0,3,0,0,3
forget,0,3,0,0,3
burdens,0,3,0,0,3
separated,0,3,0,0,3
operational,0,3,0,0,3
personal,0,3,0,0,3
getting,0,3,0,0,3
leisurely,0,3,0,0,3
pause,0,3,0,0,3
removal,0,3,0,0,3
hassles,0,3,0,0,3
stroll,0,3,0,0,3
dedicated,0,3,0,0,3
suitable,0,3,0,0,3
commuting,0,3,0,0,3
stress,0,3,0,0,3
disconnection,0,3,0,0,3
disengaging,0,3,0,0,3
personnel,0,3,0,0,3
effect,0,3,0,0,3
sitting,0,3,0,0,3
anchor,0,3,0,0,3
chance,0,3,0,0,3
nearby,1,2,0,0,3
fundamentally,1,2,0,0,3
fosters,1,2,0,0,3
devoid,1,2,0,0,3
practical,1,2,0,0,3
living,1,2,0,0,3
commonplace,1,2,0,0,3
functions,0,2,1,0,3
wildness,0,2,1,0,3
oriented,0,2,0,1,3
storage,0,2,0,1,3
act,0,2,0,1,3
70,0,2,1,0,3
continued,0,2,0,1,3
extreme,2,1,0,0,3
presentation,2,1,0,0,3
demand,2,1,0,0,3
poles,1,1,1,0,3
fulfilling,1,1,0,1,3
disrepair,1,1,1,0,3
disrupted,1,1,1,0,3
items,1,1,1,0,3
statue,1,1,1,0,3
cell,1,1,1,0,3
containers,1,1,1,0,3
shops,1,1,1,0,3
posts,1,1,1,0,3
supporting,1,1,1,0,3
experiences,1,1,0,1,3
surrounded,1,1,1,0,3
focused,0,1,0,2,3
entrances,0,1,1,1,3
evidence,0,1,0,2,3
gate,0,1,0,2,3
bike,0,1,1,1,3
imposing,0,1,1,1,3
tidy,0,1,2,0,3
disruptive,0,1,2,0,3
reinforce,0,1,2,0,3
factor,3,0,0,0,3
fascinated,3,0,0,0,3
variation,3,0,0,0,3
moderates,3,0,0,0,3
continuously,3,0,0,0,3
dynamism,3,0,0,0,3
types,3,0,0,0,3
dull,3,0,0,0,3
dramatic,3,0,0,0,3
unengaging,3,0,0,0,3
speed,3,0,0,0,3
observer,3,0,0,0,3
dominating,3,0,0,0,3
exercise,3,0,0,0,3
holding,3,0,0,0,3
richly,3,0,0,0,3
asphalt,3,0,0,0,3
soft,3,0,0,0,3
reflective,3,0,0,0,3
air,2,0,0,1,3
glimpse,2,0,0,1,3
broken,2,0,1,0,3
positive,2,0,0,1,3
graffiti,2,0,1,0,3
architecturally,2,0,1,0,3
adding,1,0,2,0,3
parkland,1,0,0,2,3
connecting,1,0,2,0,3
fewer,1,0,0,2,3
dry,1,0,2,0,3
invites,1,0,0,2,3
noticeable,1,0,2,0,3
geometric,1,0,2,0,3
rolling,1,0,0,2,3
size,1,0,0,2,3
stretch,1,0,0,2,3
plantings,1,0,2,0,3
heights,1,0,2,0,3
end,1,0,0,2,3
lighting,1,0,2,0,3
continue,0,0,0,3,3
seeming,0,0,3,0,3
function,0,0,2,1,3
elaborate,0,0,3,0,3
unclear,0,0,0,3,3
mixed,0,0,3,0,3
venture,0,0,0,3,3
surface,0,0,3,0,3
sprawling,0,0,3,0,3
recedes,0,0,0,3,3
roam,0,0,0,3,3
territories,0,0,0,3,3
traversing,0,0,0,3,3
characteristic,0,0,0,3,3
restricting,0,0,0,3,3
perspectives,0,0,0,3,3
median,0,0,3,0,3
includes,0,0,0,3,3
confines,0,0,0,3,3
thoughtful,0,0,3,0,3
integrate,0,0,3,0,3
integrates,0,0,3,0,3
readily,0,0,1,2,3
information,0,0,0,3,3
unity,0,0,3,0,3
reinforcing,0,0,2,1,3
established,0,0,0,3,3
invitation,0,0,0,3,3
defines,0,0,1,2,3
verges,0,0,3,0,3
reveal,0,0,1,2,3
rigidly,0,0,3,0,3
levels,0,0,3,0,3
roadside,0,0,1,2,3
onward,0,0,0,3,3
distances,0,0,0,3,3
narrow,0,0,0,3,3
landmarks,0,0,3,0,3
reality,0,2,0,0,2
task,0,2,0,0,2
taking,0,2,0,0,2
sources,0,2,0,0,2
users,0,2,0,0,2
relax,0,2,0,0,2
yielding,0,2,0,0,2
roof,0,2,0,0,2
remoteness,0,2,0,0,2
relaxing,0,2,0,0,2
rural,0,2,0,0,2
signals,0,2,0,0,2
signal,0,2,0,0,2
separates,0,2,0,0,2
walker,0,2,0,0,2
seek,0,2,0,0,2
embody,0,2,0,0,2
effective,0,2,0,0,2
distract,0,2,0,0,2
external,0,2,0,0,2
explicit,0,2,0,0,2
cameras,0,2,0,0,2
aside,0,2,0,0,2
busier,0,2,0,0,2
bin,0,2,0,0,2
behind,0,2,0,0,2
acts,0,2,0,0,2
dampen,0,2,0,0,2
corporate,0,2,0,0,2
38,0,2,0,0,2
controls,0,2,0,0,2
accessibility,0,2,0,0,2
achieved,0,2,0,0,2
back,0,2,0,0,2
isolation,0,2,0,0,2
outdoors,0,2,0,0,2
occur,0,2,0,0,2
nuis,0,2,0,0,2
nuisà°·à±à°ness,0,2,0,0,2
influences,0,2,0,0,2
impersonal,0,2,0,0,2
grounded,0,2,0,0,2
businesses,1,1,0,0,2
description,1,1,0,0,2
running,1,1,0,0,2
75,1,1,0,0,2
curved,1,1,0,0,2
reflecting,1,1,0,0,2
someone,1,1,0,0,2
amidst,1,1,0,0,2
assigned,1,1,0,0,2
kiosk,1,1,0,0,2
neglect,1,1,0,0,2
figures,1,1,0,0,2
bank,1,1,0,0,2
consequently,1,1,0,0,2
units,1,1,0,0,2
filled,1,1,0,0,2
trigger,1,1,0,0,2
promotes,0,1,1,0,2
presenting,0,1,0,1,2
pronounced,0,1,1,0,2
progress,0,1,1,0,2
prior,0,1,0,1,2
pavements,0,1,1,0,2
skyline,0,1,0,1,2
traversable,0,1,0,1,2
treelined,0,1,0,1,2
thoroughfares,0,1,1,0,2
rise,0,1,1,0,2
results,0,1,0,1,2
rubble,0,1,1,0,2
verdant,0,1,0,1,2
warranting,0,1,0,1,2
district,0,1,0,1,2
enhancing,0,1,1,0,2
entry,0,1,1,0,2
fabric,0,1,1,0,2
amenity,0,1,0,1,2
apartments,0,1,1,0,2
65,0,1,1,0,2
maintains,0,1,1,0,2
machinery,0,1,1,0,2
knowledge,0,1,0,1,2
implication,0,1,0,1,2
inclusion,0,1,0,1,2
indicative,0,1,1,0,2
go,0,1,1,0,2
posters,2,0,0,0,2
streetlamps,2,0,0,0,2
endlessly,2,0,0,0,2
provoke,2,0,0,0,2
blending,2,0,0,0,2
blooming,2,0,0,0,2
stronger,2,0,0,0,2
bumps,2,0,0,0,2
row,2,0,0,0,2
rider,2,0,0,0,2
senses,2,0,0,0,2
sameness,2,0,0,0,2
channel,2,0,0,0,2
season,2,0,0,0,2
reflections,2,0,0,0,2
booths,2,0,0,0,2
engrossing,2,0,0,0,2
unvaried,2,0,0,0,2
leaf,2,0,0,0,2
vibrancy,2,0,0,0,2
vibrant,2,0,0,0,2
allure,2,0,0,0,2
attraction,2,0,0,0,2
averted,2,0,0,0,2
constantly,2,0,0,0,2
pleasantness,2,0,0,0,2
flags,2,0,0,0,2
umbrella,2,0,0,0,2
uninteresting,2,0,0,0,2
stonework,1,0,1,0,2
detailed,1,0,1,0,2
circular,1,0,1,0,2
dirt,1,0,1,0,2
60,1,0,0,1,2
shipping,1,0,1,0,2
rectangular,1,0,1,0,2
bollards,1,0,1,0,2
domed,1,0,1,0,2
criteria,1,0,0,1,2
diversions,1,0,0,1,2
middle,1,0,0,1,2
gravel,1,0,1,0,2
wooded,1,0,0,1,2
variability,1,0,1,0,2
captured,1,0,0,1,2
juxtaposed,1,0,1,0,2
intrinsic,1,0,1,0,2
introducing,1,0,1,0,2
identical,1,0,1,0,2
impact,1,0,1,0,2
painted,1,0,1,0,2
pillars,1,0,1,0,2
formations,1,0,0,1,2
forking,1,0,1,0,2
cobblestone,1,0,1,0,2
uninspiring,1,0,1,0,2
otherwise,1,0,1,0,2
absolute,0,0,2,0,2
tightly,0,0,0,2,2
systems,0,0,2,0,2
strip,0,0,2,0,2
organic,0,0,2,0,2
strict,0,0,0,2,2
organically,0,0,2,0,2
occupying,0,0,2,0,2
intention,0,0,2,0,2
fragmentation,0,0,2,0,2
formal,0,0,2,0,2
purposeful,0,0,2,0,2
flowing,0,0,2,0,2
glance,0,0,2,0,2
placements,0,0,2,0,2
going,0,0,1,1,2
framework,0,0,2,0,2
possess,0,0,2,0,2
unseen,0,0,0,2,2
pristine,0,0,2,0,2
respective,0,0,2,0,2
roadsides,0,0,2,0,2
traversal,0,0,0,2,2
somewhere,0,0,1,1,2
spread,0,0,2,0,2
stability,0,0,2,0,2
stairs,0,0,2,0,2
grown,0,0,2,0,2
uncharted,0,0,0,2,2
unboundedness,0,0,0,2,2
fits,0,0,2,0,2
medians,0,0,2,0,2
inconsistency,0,0,2,0,2
distortion,0,0,2,0,2
obstructions,0,0,0,2,2
disruptions,0,0,2,0,2
linearity,0,0,0,2,2
endedness,0,0,0,2,2
cracked,0,0,2,0,2
exist,0,0,0,2,2
definitive,0,0,0,2,2
opens,0,0,0,2,2
hindering,0,0,2,0,2
maintaining,0,0,2,0,2
constraints,0,0,0,2,2
unevenness,0,0,2,0,2
continuing,0,0,0,2,2
impacting,0,0,2,0,2
outwards,0,0,0,2,2
courtyard,0,0,0,2,2
inconsistencies,0,0,2,0,2
landmark,0,0,2,0,2
front,0,0,0,2,2
gated,0,0,0,2,2
giving,0,0,0,2,2
demonstrate,0,0,2,0,2
disharmony,0,0,2,0,2
fronts,0,0,0,2,2
experiencing,0,0,0,2,2
island,0,0,2,0,2
decipherable,0,0,2,0,2
disorganization,0,0,2,0,2
definition,0,0,1,1,2
effortless,0,0,2,0,2
meticulous,0,0,2,0,2
borders,0,0,2,0,2
bricks,0,0,2,0,2
perimeter,0,0,0,2,2
showing,0,0,0,2,2
revealed,0,0,0,2,2
effort,0,0,2,0,2
severely,0,0,0,2,2
navigating,0,0,2,0,2
restrictions,0,0,0,2,2
uninterrupted,0,0,1,1,2
guides,0,0,2,0,2
unifying,0,0,2,0,2
exact,0,0,1,1,2
entirety,0,0,2,0,2
unobstructed,0,0,1,1,2
amenities,0,0,2,0,2
upkeep,0,0,2,0,2
artistic,0,0,2,0,2
confining,0,0,0,2,2
constrain,0,0,0,2,2
properties,0,0,0,2,2
markers,0,0,2,0,2
sheltered,0,1,0,0,1
contemporary,0,1,0,0,1
closely,0,1,0,0,1
cognitive,0,1,0,0,1
commerce,0,1,0,0,1
commonly,0,1,0,0,1
congestion,0,1,0,0,1
connections,0,1,0,0,1
contains,0,1,0,0,1
contemplative,0,1,0,0,1
contrasted,0,1,0,0,1
clamor,0,1,0,0,1
cutting,0,1,0,0,1
de,0,1,0,0,1
deliver,0,1,0,0,1
demolition,0,1,0,0,1
desired,0,1,0,0,1
cleanliness,0,1,0,0,1
civic,0,1,0,0,1
litter,0,1,0,0,1
aesthetics,0,1,0,0,1
aid,0,1,0,0,1
associations,0,1,0,0,1
awayness,0,1,0,0,1
baidu,0,1,0,0,1
barrier,0,1,0,0,1
block,0,1,0,0,1
calmness,0,1,0,0,1
candidate,0,1,0,0,1
carry,0,1,0,0,1
ceasing,0,1,0,0,1
centers,0,1,0,0,1
certainly,0,1,0,0,1
change,0,1,0,0,1
character,0,1,0,0,1
characterize,0,1,0,0,1
detaches,0,1,0,0,1
detaching,0,1,0,0,1
inputs,0,1,0,0,1
firmly,0,1,0,0,1
flux,0,1,0,0,1
focusing,0,1,0,0,1
forgetting,0,1,0,0,1
hinder,0,1,0,0,1
hinders,0,1,0,0,1
honking,0,1,0,0,1
incomplete,0,1,0,0,1
inconvenience,0,1,0,0,1
instance,0,1,0,0,1
institution,0,1,0,0,1
insulating,0,1,0,0,1
interior,0,1,0,0,1
intervention,0,1,0,0,1
involve,0,1,0,0,1
isolating,0,1,0,0,1
keeps,0,1,0,0,1
leave,0,1,0,0,1
leaving,0,1,0,0,1
lightly,0,1,0,0,1
feelings,0,1,0,0,1
featureless,0,1,0,0,1
fatigue,0,1,0,0,1
directly,0,1,0,0,1
disconnecting,0,1,0,0,1
dispersed,0,1,0,0,1
display,0,1,0,0,1
distracts,0,1,0,0,1
done,0,1,0,0,1
embedded,0,1,0,0,1
emphasis,0,1,0,0,1
encounter,0,1,0,0,1
escapism,0,1,0,0,1
excessive,0,1,0,0,1
exposed,0,1,0,0,1
administrative,0,1,0,0,1
acting,0,1,0,0,1
ac,0,1,0,0,1
40,0,1,0,0,1
12304,0,1,0,0,1
28740,0,1,0,0,1
31,0,1,0,0,1
linked,0,1,0,0,1
lone,0,1,0,0,1
machine,0,1,0,0,1
uninviting,0,1,0,0,1
thanks,0,1,0,0,1
think,0,1,0,0,1
thought,0,1,0,0,1
time,0,1,0,0,1
trafficked,0,1,0,0,1
unconventional,0,1,0,0,1
uncrowded,0,1,0,0,1
unpleasant,0,1,0,0,1
ä¸­å½ä¸­é,0,1,0,0,1
unpopulated,0,1,0,0,1
unrefined,0,1,0,0,1
unwind,0,1,0,0,1
used,0,1,0,0,1
usually,0,1,0,0,1
vending,0,1,0,0,1
viewpoint,0,1,0,0,1
weak,0,1,0,0,1
support,0,1,0,0,1
plentiful,0,1,0,0,1
obscure,0,1,0,0,1
occupy,0,1,0,0,1
organizing,0,1,0,0,1
palpable,0,1,0,0,1
parcel,0,1,0,0,1
passing,0,1,0,0,1
physically,0,1,0,0,1
pipes,0,1,0,0,1
recharge,0,1,0,0,1
preoccupations,0,1,0,0,1
promote,0,1,0,0,1
prospect,0,1,0,0,1
purposes,0,1,0,0,1
quieter,0,1,0,0,1
realities,0,1,0,0,1
nuisà°·à±à°ances,0,1,0,0,1
nuisà°·à±à°,0,1,0,0,1
nuismas,0,1,0,0,1
meaning,0,1,0,0,1
mid,0,1,0,0,1
milder,0,1,0,0,1
minds,0,1,0,0,1
moment,0,1,0,0,1
monitored,0,1,0,0,1
motorcycle,0,1,0,0,1
must,0,1,0,0,1
mÃ¼Återiler,0,1,0,0,1
needs,0,1,0,0,1
neglected,0,1,0,0,1
noisy,0,1,0,0,1
nuisabilities,0,1,0,0,1
nuisability,0,1,0,0,1
nuiscations,0,1,0,0,1
nuisciances,0,1,0,0,1
nuiscombs,0,1,0,0,1
nuiscomes,0,1,0,0,1
nuiskuances,0,1,0,0,1
recognizable,0,1,0,0,1
students,0,1,0,0,1
service,0,1,0,0,1
serving,0,1,0,0,1
shade,0,1,0,0,1
shaded,0,1,0,0,1
shedding,0,1,0,0,1
shifting,0,1,0,0,1
shutting,0,1,0,0,1
signifies,0,1,0,0,1
signify,0,1,0,0,1
situations,0,1,0,0,1
recognizably,0,1,0,0,1
slow,0,1,0,0,1
societal,0,1,0,0,1
softer,0,1,0,0,1
stored,0,1,0,0,1
stressful,0,1,0,0,1
strictly,0,1,0,0,1
strolling,0,1,0,0,1
strolls,0,1,0,0,1
scenic,0,1,0,0,1
satisfy,0,1,0,0,1
recreation,0,1,0,0,1
recycling,0,1,0,0,1
refreshing,0,1,0,0,1
regulated,0,1,0,0,1
relaxed,0,1,0,0,1
reminded,0,1,0,0,1
reminders,0,1,0,0,1
removes,0,1,0,0,1
represents,0,1,0,0,1
requires,0,1,0,0,1
requiring,0,1,0,0,1
resembles,0,1,0,0,1
rest,0,1,0,0,1
restoration,0,1,0,0,1
retain,0,1,0,0,1
return,0,1,0,0,1
ride,0,1,0,0,1
cans,1,0,0,0,1
cascading,1,0,0,0,1
capturing,1,0,0,0,1
casual,1,0,0,0,1
budding,1,0,0,0,1
centric,1,0,0,0,1
canopies,1,0,0,0,1
sculptures,1,0,0,0,1
brickwork,1,0,0,0,1
alternating,1,0,0,0,1
alter,1,0,0,0,1
architectures,1,0,0,0,1
availability,1,0,0,0,1
autumnal,1,0,0,0,1
attractions,1,0,0,0,1
arrows,1,0,0,0,1
absorbed,1,0,0,0,1
36,1,0,0,0,1
alleviated,1,0,0,0,1
alleviating,1,0,0,0,1
absorbing,1,0,0,0,1
bodies,1,0,0,0,1
best,1,0,0,0,1
bench,1,0,0,0,1
breaking,1,0,0,0,1
boulder,1,0,0,0,1
boost,1,0,0,0,1
avoidance,1,0,0,0,1
bark,1,0,0,0,1
bare,1,0,0,0,1
induce,1,0,0,0,1
indistinct,1,0,0,0,1
images,1,0,0,0,1
holds,1,0,0,0,1
historically,1,0,0,0,1
hilly,1,0,0,0,1
hidden,1,0,0,0,1
intricacies,1,0,0,0,1
keep,1,0,0,0,1
issue,1,0,0,0,1
intrigued,1,0,0,0,1
intersections,1,0,0,0,1
input,1,0,0,0,1
inspire,1,0,0,0,1
held,1,0,0,0,1
fountain,1,0,0,0,1
grove,1,0,0,0,1
gatehouse,1,0,0,0,1
groups,1,0,0,0,1
grey,1,0,0,0,1
golden,1,0,0,0,1
genuinely,1,0,0,0,1
gently,1,0,0,0,1
generating,1,0,0,0,1
gazebo,1,0,0,0,1
gaze,1,0,0,0,1
gateway,1,0,0,0,1
prevented,1,0,0,0,1
sparks,1,0,0,0,1
species,1,0,0,0,1
specifically,1,0,0,0,1
spherical,1,0,0,0,1
quickly,1,0,0,0,1
stay,1,0,0,0,1
steamroller,1,0,0,0,1
prone,1,0,0,0,1
prompts,1,0,0,0,1
stimulus,1,0,0,0,1
storefronts,1,0,0,0,1
suspension,1,0,0,0,1
streetlamp,1,0,0,0,1
presentable,1,0,0,0,1
pot,1,0,0,0,1
post,1,0,0,0,1
pockets,1,0,0,0,1
plays,1,0,0,0,1
playground,1,0,0,0,1
playful,1,0,0,0,1
plant,1,0,0,0,1
pique,1,0,0,0,1
sparking,1,0,0,0,1
red,1,0,0,0,1
reddish,1,0,0,0,1
something,1,0,0,0,1
sculptural,1,0,0,0,1
scootering,1,0,0,0,1
series,1,0,0,0,1
sand,1,0,0,0,1
shades,1,0,0,0,1
shadow,1,0,0,0,1
shared,1,0,0,0,1
sheer,1,0,0,0,1
shelving,1,0,0,0,1
short,1,0,0,0,1
rusty,1,0,0,0,1
rounded,1,0,0,0,1
sign,1,0,0,0,1
role,1,0,0,0,1
rocks,1,0,0,0,1
simplicity,1,0,0,0,1
sizes,1,0,0,0,1
repetitiveness,1,0,0,0,1
renovation,1,0,0,0,1
remain,1,0,0,0,1
softens,1,0,0,0,1
piled,1,0,0,0,1
sustain,1,0,0,0,1
meandering,1,0,0,0,1
negate,1,0,0,0,1
van,1,0,0,0,1
mystery,1,0,0,0,1
mound,1,0,0,0,1
verge,1,0,0,0,1
monument,1,0,0,0,1
modes,1,0,0,0,1
visitor,1,0,0,0,1
metal,1,0,0,0,1
mentioned,1,0,0,0,1
wealth,1,0,0,0,1
tapestry,1,0,0,0,1
35478,1,0,0,0,1
lilies,1,0,0,0,1
likelihood,1,0,0,0,1
wildlife,1,0,0,0,1
layered,1,0,0,0,1
wooden,1,0,0,0,1
â¥ï¸,1,0,0,0,1
unremarkable,1,0,0,0,1
neutral,1,0,0,0,1
nice,1,0,0,0,1
notice,1,0,0,0,1
peak,1,0,0,0,1
tent,1,0,0,0,1
textural,1,0,0,0,1
passively,1,0,0,0,1
palm,1,0,0,0,1
track,1,0,0,0,1
overbearing,1,0,0,0,1
translate,1,0,0,0,1
transportation,1,0,0,0,1
outcome,1,0,0,0,1
treeline,1,0,0,0,1
ornate,1,0,0,0,1
ornamental,1,0,0,0,1
type,1,0,0,0,1
ordinariness,1,0,0,0,1
umbrellas,1,0,0,0,1
unadorned,1,0,0,0,1
underdeveloped,1,0,0,0,1
understated,1,0,0,0,1
unexpectedness,1,0,0,0,1
uninspired,1,0,0,0,1
contrasting,1,0,0,0,1
deck,1,0,0,0,1
cylindrical,1,0,0,0,1
currently,1,0,0,0,1
cultural,1,0,0,0,1
conventional,1,0,0,0,1
constant,1,0,0,0,1
colonnaded,1,0,0,0,1
cloud,1,0,0,0,1
clock,1,0,0,0,1
chinese,1,0,0,0,1
combat,1,0,0,0,1
conditioning,1,0,0,0,1
conditioners,1,0,0,0,1
communication,1,0,0,0,1
comfortable,1,0,0,0,1
described,1,0,0,0,1
detracting,1,0,0,0,1
evoked,1,0,0,0,1
entertained,1,0,0,0,1
encounters,1,0,0,0,1
enchanting,1,0,0,0,1
emphasized,1,0,0,0,1
embankment,1,0,0,0,1
elevate,1,0,0,0,1
exciting,1,0,0,0,1
extremely,1,0,0,0,1
extraordinary,1,0,0,0,1
dynamicism,1,0,0,0,1
disappearing,1,0,0,0,1
distinguishing,1,0,0,0,1
diminished,1,0,0,0,1
diffused,1,0,0,0,1
distribution,1,0,0,0,1
dome,1,0,0,0,1
dynamically,1,0,0,0,1
drives,1,0,0,0,1
dramatically,1,0,0,0,1
dominates,1,0,0,0,1
16615,1,0,0,0,1
intricately,0,0,1,0,1
manageability,0,0,1,0,1
hoc,0,0,1,0,1
networks,0,0,1,0,1
picture,0,0,1,0,1
greenness,0,0,1,0,1
nevertheless,0,0,1,0,1
patchy,0,0,1,0,1
guidance,0,0,1,0,1
guiding,0,0,1,0,1
intent,0,0,1,0,1
older,0,0,1,0,1
lean,0,0,1,0,1
near,0,0,1,0,1
language,0,0,1,0,1
ingrained,0,0,1,0,1
piecemeal,0,0,1,0,1
meant,0,0,1,0,1
grander,0,0,1,0,1
overarching,0,0,1,0,1
patchwork,0,0,1,0,1
growth,0,0,1,0,1
perceivable,0,0,1,0,1
memorable,0,0,1,0,1
impacts,0,0,1,0,1
naturalized,0,0,1,0,1
jumbled,0,0,1,0,1
navigability,0,0,1,0,1
material,0,0,1,0,1
helps,0,0,1,0,1
hierarchy,0,0,1,0,1
imposes,0,0,0,1,1
incorporates,0,0,0,1,1
indeed,0,0,0,1,1
indefinitely,0,0,0,1,1
infinitely,0,0,0,1,1
investigate,0,0,0,1,1
justifying,0,0,0,1,1
land,0,0,0,1,1
least,0,0,0,1,1
limitlessly,0,0,0,1,1
mobility,0,0,0,1,1
navigated,0,0,0,1,1
observed,0,0,0,1,1
obstruction,0,0,0,1,1
opening,0,0,0,1,1
options,0,0,0,1,1
inaccessible,0,0,0,1,1
placidity,0,0,1,0,1
guided,0,0,0,1,1
enclosing,0,0,0,1,1
encouraging,0,0,0,1,1
expand,0,0,0,1,1
extensively,0,0,0,1,1
faintly,0,0,0,1,1
flat,0,0,0,1,1
forest,0,0,0,1,1
formed,0,0,0,1,1
gardens,0,0,0,1,1
generous,0,0,0,1,1
gradual,0,0,0,1,1
great,0,0,0,1,1
greater,0,0,0,1,1
outward,0,0,0,1,1
packed,0,0,0,1,1
parameters,0,0,0,1,1
passage,0,0,0,1,1
taller,0,0,0,1,1
tanks,0,0,0,1,1
trails,0,0,0,1,1
treed,0,0,0,1,1
turns,0,0,0,1,1
unconfined,0,0,0,1,1
unfettered,0,0,0,1,1
unguided,0,0,0,1,1
unimpeded,0,0,0,1,1
uninhibited,0,0,0,1,1
unknown,0,0,0,1,1
vanishing,0,0,0,1,1
vastly,0,0,0,1,1
vicinity,0,0,0,1,1
waterways,0,0,0,1,1
take,0,0,0,1,1
starting,0,0,0,1,1
sprawl,0,0,0,1,1
past,0,0,0,1,1
predefined,0,0,0,1,1
private,0,0,0,1,1
range,0,0,0,1,1
ranging,0,0,0,1,1
receding,0,0,0,1,1
returning,0,0,0,1,1
splits,0,0,0,1,1
roaming,0,0,0,1,1
scoped,0,0,0,1,1
screams,0,0,0,1,1
severe,0,0,0,1,1
simply,0,0,0,1,1
snapshot,0,0,0,1,1
discourage,0,0,0,1,1
disappears,0,0,0,1,1
directionality,0,0,0,1,1
untidy,0,0,1,0,1
smoother,0,0,1,0,1
soil,0,0,1,0,1
sometimes,0,0,1,0,1
spatially,0,0,1,0,1
states,0,0,1,0,1
strategically,0,0,1,0,1
symmetrically,0,0,1,0,1
symmetry,0,0,1,0,1
tactile,0,0,1,0,1
theme,0,0,1,0,1
tiered,0,0,1,0,1
tiles,0,0,1,0,1
trimming,0,0,1,0,1
unmanaged,0,0,1,0,1
slopes,0,0,1,0,1
singular,0,0,1,0,1
showcases,0,0,1,0,1
regimented,0,0,1,0,1
portion,0,0,1,0,1
process,0,0,1,0,1
purposefully,0,0,1,0,1
racks,0,0,1,0,1
railing,0,0,1,0,1
rating,0,0,1,0,1
relation,0,0,1,0,1
sharp,0,0,1,0,1
rightful,0,0,1,0,1
roundabout,0,0,1,0,1
section,0,0,1,0,1
segmentation,0,0,1,0,1
separations,0,0,1,0,1
unstructured,0,0,1,0,1
wear,0,0,1,0,1
directed,0,0,0,1,1
white,0,0,1,0,1
boundedness,0,0,0,1,1
cannot,0,0,0,1,1
claustrophobic,0,0,0,1,1
complexes,0,0,0,1,1
garden,0,0,1,0,1
consist,0,0,0,1,1
constraint,0,0,0,1,1
constricting,0,0,0,1,1
containing,0,0,0,1,1
converging,0,0,0,1,1
corridor,0,0,0,1,1
courtyards,0,0,0,1,1
delineating,0,0,0,1,1
demarcation,0,0,0,1,1
demarcations,0,0,0,1,1
densely,0,0,0,1,1
beaten,0,0,0,1,1
adjoining,0,0,0,1,1
adequate,0,0,0,1,1
48971,0,0,0,1,1
13,0,0,0,1,1
17,0,0,0,1,1
29,0,0,0,1,1
30,0,0,0,1,1
41,0,0,0,1,1
44,0,0,0,1,1
57974,0,0,0,1,1
across,0,0,0,1,1
59,0,0,0,1,1
725,0,0,0,1,1
80,0,0,0,1,1
absent,0,0,0,1,1
access,0,0,0,1,1
accommodate,0,0,0,1,1
gates,0,0,1,0,1
garage,0,0,1,0,1
furniture,0,0,1,0,1
approach,0,0,1,0,1
55,0,0,1,0,1
72,0,0,1,0,1
76,0,0,1,0,1
ad,0,0,1,0,1
advertisements,0,0,1,0,1
affect,0,0,1,0,1
alignment,0,0,1,0,1
alignments,0,0,1,0,1
anticipate,0,0,1,0,1
appropriately,0,0,1,0,1
47607,0,0,1,0,1
attempt,0,0,1,0,1
balls,0,0,1,0,1
bases,0,0,1,0,1
beds,0,0,1,0,1
belonging,0,0,1,0,1
belts,0,0,1,0,1
blue,0,0,1,0,1
breaks,0,0,1,0,1
carelessly,0,0,1,0,1
centerline,0,0,1,0,1
48,0,0,1,0,1
38934,0,0,1,0,1
clearings,0,0,1,0,1
commanding,0,0,1,0,1
distinction,0,0,1,0,1
distinctions,0,0,1,0,1
distortions,0,0,1,0,1
distorts,0,0,1,0,1
distributed,0,0,1,0,1
diverge,0,0,1,0,1
divides,0,0,1,0,1
dividing,0,0,1,0,1
doors,0,0,1,0,1
earning,0,0,1,0,1
emphasizes,0,0,1,0,1
complement,0,0,1,0,1
entire,0,0,1,0,1
every,0,0,1,0,1
exceptional,0,0,1,0,1
exhibiting,0,0,1,0,1
exude,0,0,1,0,1
fitting,0,0,1,0,1
functionalities,0,0,1,0,1
disrupting,0,0,1,0,1
disparate,0,0,1,0,1
disordered,0,0,1,0,1
complements,0,0,1,0,1
component,0,0,1,0,1
conceptual,0,0,1,0,1
condition,0,0,1,0,1
conditions,0,0,1,0,1
confusing,0,0,1,0,1
connect,0,0,1,0,1
consistency,0,0,1,0,1
curated,0,0,1,0,1
deciphered,0,0,1,0,1
deliberately,0,0,1,0,1
demarcated,0,0,1,0,1
densities,0,0,1,0,1
differing,0,0,1,0,1
digestible,0,0,1,0,1
directs,0,0,1,0,1
discarded,0,0,1,0,1
